-----------------------------------o-----------------------------------?------------?-------------------------------------------------------------------------------------------------------------------
---------------------B-----------M------------------------------------------------------------------------------------------------M---------------------------------------------------------------------
-------------------------------------------------B-----B----------------------------------------------------------------------------------------------??----------------------------------------o-------
-M-----------------------------------------o----------XXXXXX--------------------------------------------------------------------------------------------------------------------------------------------
-----------------------------------T----TT--XXXXXXXXXX------X-----X-------------------X-----------------------------------------------------------------------------------------------------------------
-----------------------------------|--X-||-------X----XX---XX-X--XX-T------X---------XX--------------------X--------X-----------------------------------------------------------------------------------
-m------XXXXXXXXM-------T-----M---B|B-XX||TT--T-XX---XXXX-XXX---XXX-|------XX-------XXX-------------------XX--------------------------------------------------------------------------------------------
-T---T---o--------------|----------|--XX||||-X|XXX--XXXXXXXXX--XXXX-|------XXX-----XXXX----------o-------XXX-----------------------------------------------------------------------M-------------------v
-|---|------------------|---------o|--XX||||XX|XXXXXXXXXXXXXX-XXXXX-|------XXXX---XXXXX-----------------XXXX------------------------------------------X------------------------------------------o-----f
-|---|------------------|---------B|B-XX||||XX|XXXXXXXXXXXXXXXXXXXX-|------XXXXX-XXXXXX-T--------------XXXXX-----------------------------------------XX------------------------------------------------f
-|---|------------------|----------|--XX||||XX|XXXXXXXXXXXXXXXXXXXX-|------XXXXXXXXXXXX-|-----------M-XXXXXX----------------------------------------XXX--X----------------------------------X----------f
-|---|------------------|---T------|--XX||||XX|XXXXXXXXXXXXXXXXXXXX-|------XXXXXXXXXXXX-|------------XXXXXXX--X-------------------B----------------XXXX--XX-------------X------------------XX----------f
-|---|------------------|---|------|--XX||||XX|XXXXXXXXXXXXXXXXXXXX-|------XXXXXXXXXXXX-|-----------XXXXXXXX-XX-------------M----X----------------XXXXX--XXX-----M-----XX-----------------XXX----------f
-|---|------------------|---|------|--XX||||XX|XXXXXXXXXXXXXXXXXXXX-|------XXXXXXXXXXXX-|----------XXXXXXXXXXXX------------------------X---------XXXXXX--XXXX---------XXX----------------XXXX----------f
-|E--|----------------E-|---|------|--XX||||XX|XXXXXXXXXXXXXXXXXXXX-|------XXXXXXXXXXXX-|--------EXXXXXXXXXXXXX-----------------------XX-----E--XXXXXXX--XXXXXE------XXXX---B-------E---XXXXX----------X
X|XXX|-----o------------|---|------|--XX||||XX|XXXXXXXXXXXXXXXXXXXX-|------XXXXXXXXXXXX-|--------XXXXXXXXXXXXXX----------------------XXX???----XXXXXXXX--XXXXXX-----XXXXX--------------XXXXXX----------X
