--------------------------------------------------------------------------------------------------------------------------------------------------------------------------------------------------------
--------------------------------------------------------------------------------------------------------------------------------------------------------------------------------------------------------
--------------------------------------------------------------------------------------------------------------------------------------------------------------------------------------------------------
--------------------------------------------------------------------------------------------------------------------------------------------------------------------------------------------------------
--------------------------------------------------------------------------------------------------------------------------------------------------------------------------------------------------------
--------------------------------------------------------------------------------------------------------------------------------------------------------------------------------------------------------
--------------------------------------------------------------------------------------------------------------------------------------------------------------------------------------------------------
-------------------------------------------------------------------------------------------------------------------------------------------------------------------------------------------------------v
-------------------------------------------------------------------------------------------------------------------------------------------------------------------------------------------------------f
-X---X------X-XX-------XX--X----------X---------X--------------XX------X-X----X-X--XX-----X-----X----------XX----X-------------X-X------X---------X-------X---------------X----XX-X----------XX--X--X--f
------X------X-X-X------X-----X---X---X-----------XX--------------------------XXX-------------------X-------X------------X----------X---X---X-X---X---X---X----X----X------X---------------X-X---------f
-X--X------------X---------X--------X------X---XX---X----XX----XX-----X---X-------------XX--XX-----------X-X-----------------X---X----XX----X----------X-X--X-X--X--X----------------------XX----------f
-X---------X-X-------X--X---XX--X---------X---X--XX--------X--X-X----X----X------------XX---------------X--------X-X--XX----------X--X-----------XXX--X----X-----X--X-------X---XX--------------X----X-f
--X-----X----------X-X--XX-------------XX-X---------------------------XX-X--X----X-------------X------X-----X---X-------X----X----X--X--XX--X-X-----XX--X-------X---X--X--------X----X--X------X----XX-f
m---X----X-X--X---X-X-X--X---X--X-X------X------X-XXX-X----------X--X---XXXX-X-X----X-X-XXX--X-X-X--X-X-XX-X-------XX-XX-X-X------X------X-X-X--XX-X---X---X----X----X-------XXXXX-X-X----XX-X------X--X
XXXXX--------------------------------------------------------------------------------------------------------------------------------------------------------------------------------------------------X
